With a crucifix - I smash her body
The deformation - is grotesque
My passion crawls - for your flesh
The ritual - can begin

Turn the cross - upside down
Into her - bleeding cunt
Urinate - in her mouth
Hack and fuck - for supper

Blackest
Ecstasy
Beyond the - boundaries
of pleasure

Sucking out - eating raw flesh
Fuck you whore - we burn in blasphemy
For sex I'll use her lovely head
Delightful orgasm - so deep in me

Blackest
Ecstasy
Beyond the - boundaries
of pleasure

I spill out - blackest blood
Prepare your return - this place you'll never leave
Ich liebe es - wie du dich mir
Von hinte effnest - schwarz und kalt
(Voll toter Romantik)
Evil thoughts - full of perversion
What a beautiful view - when I scratch your bones
Das Blutopfer - bestialisch rotverschmiert
Der Himmel ist unsere Helle -
Das Martyrium der Todeshochzeit

