Jo pimeys saa | Laskeutuu kuolleiden maahan | Alas taivas painaa pÃ¤Ã¤mme |
HÃ¤vityksen silmiltÃ¤ piilottaa |
Yksin yÃ¶stÃ¤ kurkotan valoon | Sen halki huudan: pÃ¤Ã¤stÃ¤kÃ¤Ã¤ minut! | Ei kukaan
sanaakaan sano | Tuskin
vaipuu uneen | On kajo poissa palavan maailman | Pois huuhdottu kaipuu elÃ¤mÃ¤n |
Reki raskas meitÃ¤ seuraa |
Kuolema jaloissamme | YllÃ¤ vain tÃ¤hdetÃ¶n taivas | Alla eloton maa | Jo pimeys
saavuttaa | Maailman viimeisen
reunan | Savuna karanneet muistot | Kaupungit ihmisten | Aika tÃ¤ynnÃ¤ elÃ¤mÃ¤Ã¤ |
Piirtynyt vereen ja tuhkaan |
YllÃ¤ lohduton taivas | Alla hylÃ¤tty maa | Yksin yÃ¶stÃ¤ kurkotan valoon | VielÃ¤
huudan: pÃ¤Ã¤stÃ¤kÃ¤Ã¤ minut! |
Kiehuu saastunut meri | Kuoriutuu verinen kiveys katujen | Loppumme vielÃ¤
pilviÃ¤ reunustaa | On ilma tÃ¤Ã¤llÃ¤
niin raskas | Vesi virtaa myrkkyÃ¤ | Vain sodan aseet ruostuvat | HylÃ¤ttyinÃ¤
pohjassa | Mihin haudata ruumiit? |
Minne juosta kun aurinko nousee? | NÃ¤keekÃ¶ kukaan jos kohotamme lippuamme? |
Kuuma tuuli hetken
pyyhkii rantaa | Valkoinen lintu sen mukaan katoaa | MikÃ¤Ã¤n ei elÃ¤ enÃ¤Ã¤, ei
mitÃ¤Ã¤n taakse jÃ¤Ã¤ | On askel
tÃ¤Ã¤llÃ¤ niin raskas | TietÃ¤ ei nÃ¤y kivien alta | Pohjoinen kÃ¤tkeytyy pilvien taa
| Harmaa maisema pyydystÃ¤Ã¤
aaveita | Mennyt hiljaa pyyhkiytyy taivaanrantaan | Jalkojen alla murheiden maa
| Jossa mikÃ¤Ã¤n ei elÃ¤ enÃ¤Ã¤

[English translation:]

Starless

Darkness enters | Descending upon the land of the dead | Our heads pressed down
by the sky | Hiding the
pillage from our eyes | Alone from the night I reach towards the light | Across
it I scream: release me! | No-one
speaks a word | Hardly falling asleep | Gone is the sheen of the burning world
| The yearning for life washed
away | We are followed by a heavy sleigh | In our feet:death | Above us only a
starless sky | A lifeless earth below |
Darkness now reaching | The final edge of the world | Memories gone in smoke |
Cities of the people | Time full
of life | Drawn in blood and ash | Above us only a forlorn sky | A deserted
earth below | Alone from the night I
reach towards the light | Still screaming: release me! | The polluted sea is
boiling | The bloody paving casting
off its shell | Clouds will be lined by our ending | So heavy is the air here |
Waters flowing with poison | Only
the weapons of war rust | Lying deserted at the bottom | Where to bury the
corpses? | Where to run once the
sun rises? | Will anybody see if we raise our flag? | A scorching wind briefly
strokes the shore | With it a white
bird disappears | Nothing remains alive, nothing left behind | So heavy are the
steps here | Unseen lies the
path under the stones | The North is hidden behind clouds | Ghosts are captured
by the grey landscape | The
past is silently swept away into the skyline | Under our feet the land of
sorrows | Where nothing remains alive

